#######
##.#..#
####..#
##....#
#######
