##.##.###
##.#..###
####..###
##....###
##.####.#
#########
.....####
